{
    "軟體": "软件",
    "畫": "画",
    "紹": "绍",
    "載": "载",
    "問": "问",
    "諮": "咨",
    "詢": "询",
    "將": "将",
    "動": "动",
    "視": "视",
    "災": "灾",
    "體": "体",
    "驗": "验",
    "實": "实",
    "時": "时",
    "嘯": "啸",
    "顯": "显",
    "過": "过",
    "聲": "声",
    "進": "进",
    "費": "费",
    "網": "网",
    "開": "开",
    "實": "实",
    "幾": "几",
    "無": "无",
    "遲": "迟",
    "緊": "紧",
    "報": "报",
    "並": "并",
    "語": "语",
    "視": "视",
    "覺": "觉",
    "綠": "绿",
    "調": "调",
    "簡": "简",
    "單": "单",
    "設": "设",
    "計": "计",
    "處": "处",
    "適": "适",
    "臺": "台",
    "論": "论",
    "環": "环",
    "運": "运",
    "详": "詳",
    "细": "細",
    "見": "见",
    "題": "题",
    "沒": "没",
    "確": "确",
    "認": "认",
    "請": "请",
    "電": "电",
    "郵": "邮",
    "發": "发",
    "錯": "错",
    "誤": "误",
    "聯": "联",
    "繫": "系",
    "以後": "以后",
    "讓": "让",
    "貼": "贴",
    "點": "点",
    "連結": "链接",
    "": "",
    "": "",
    "": "",
    "": ""
}
