{
    "软件": "軟體",
    "画": "畫",
    "绍": "紹",
    "载": "載",
    "问": "問",
    "咨": "諮",
    "询": "詢",
    "将": "將",
    "动": "動",
    "视": "視",
    "灾": "災",
    "体": "體",
    "验": "驗",
    "实": "實",
    "时": "時",
    "啸": "嘯",
    "显": "顯",
    "过": "過",
    "声": "聲",
    "进": "進",
    "费": "費",
    "网": "網",
    "开": "開",
    "实": "實",
    "几": "幾",
    "无": "無",
    "迟": "遲",
    "紧": "緊",
    "报": "報",
    "并": "並",
    "语": "語",
    "视": "視",
    "觉": "覺",
    "绿": "綠",
    "调": "調",
    "简": "簡",
    "单": "單",
    "设": "設",
    "计": "計",
    "处": "處",
    "适": "適",
    "台": "臺",
    "论": "論",
    "环": "環",
    "运": "運",
    "詳": "详",
    "細": "细",
    "见": "見",
    "题": "題",
    "没": "沒",
    "确": "確",
    "认": "認",
    "请": "請",
    "电": "電",
    "邮": "郵",
    "发": "發",
    "错": "錯",
    "误": "誤",
    "联": "聯",
    "系": "繫",
    "以后": "以後",
    "让": "讓",
    "贴": "貼",
    "点": "點",
    "链接": "連結",
    "": ""
}
